1111111111111111111111111111111111
1E0000000000001C10000C000000000001
1111110100100001001001000000010101
1010010010101010001001000000010101
1P0000000C00C0000000000000000000C1
1111111111111111111111111111111111