111111111111111111111111111111111111111111111111
1E00000000000000000000000000000000000000000000C1
1001010011110001111011110010001111010001011110C1
1010010000010001000010010010001001011001010000C1
1011110011110001111010010010001001010101010110C1
1000010010000000001010010010001001010011010010C1
1000010011110001111011110011101111010001011110C1
1P00000000000000000000000000000000000000000000C1
111111111111111111111111111111111111111111111111